111111111111111111111
1100CN00000C0000000C1
100110100011000000001
101111111000111100001
1E1C000000000NC0000P1
111111111111111111111
