111111111111111111111
1100C000000C0000000C1
100110100011000000001
101111111000111100001
1E1C0000000000C0000P1
111111111111111111111
